...............................
                        .     .
.  ...................  .  .  .
.                    .     .  .
...................  .......  .
.                 .  .  .     .
.  .............  .  .  .  ....
.        .     .     .        .
.......  .  .  .............  .
.    B.  .  .                 .
.  ....  .  .......  .......  .
.  .     .     .     .     .  .
.  .  .......  .  ....  .  .  .
.     .        .     .  .     .
.......  ..........  .  .......
.  .     .        .  .     .  .
.  .  .......  ....  ....  .  .
.     .        .     .     .  .
.......  .  .  .  ....  ....  .
.        .  .     .           A
...............................